0000000000000000000000000000000
1122022222022222220222220222220
0002020002000200020200020200020
0222022202022202022202220222020
0200000202020002000002000002020
0222222202220202222202220222020
0200000000000200000202020200020
0222220222220222220202020202220
0000020202020000020202000200000
0222220202022202220222022202220
0200000202000002000202020002020
0222022202220222022202022222020
0002020000020200020000000000020
0222020222222202220222222222220
0200000200020002000200000000000
0202222202220222022222220222220
0202000002000200020000020202000
0222022222022202020222220202220
0000020000020002020202020000020
0222020222022202220202022202220
0200020200020200000002000202000
0222220222020222220222022202020
0000000002000002000200020002020
0202222202222202222202020222020
0202000200000200000002020202020
0202022202220222222202222202220
0202020002020000000200020200000
0222022222022222022222220222220
0200000000000002000000000000020
0222222222222202222222222222223
0000000000000000000000000000000
